NO ./textures/mramor.xpm
SO ./textures/derevo.xpm
WE ./textures/glassfacete.xpm
EA ./textures/kirpich.xpm

F 220,100,0
C 225,30,0

        1111111111111111111111111
        1000000000110000000000001
        1011000001110000000000001
        1001000000000000000000001
111111111011000001110000000000001
100000000011000001110111101111111
11110111111111011100000010001
11110111111111011101010010001
11000000110101011100000010001
10000000000000001100000010001
1000000000000000110101001N001
110000011010101111101111000111
111101111110101 101111010001
11111111 1111111111111111111